あくあ	Aqours	名詞
しゃろん	CYaRon！	名詞
あぜりあ	AZALEA	名詞
ぎるてぃーきす	Guilty Kiss	名詞
たかみちか	高海千歌	人名
たかみ	高海	姓
ちか	千歌	名
さくらうちりこ	桜内梨子	人名
さくらうち	桜内	姓
りこ	梨子	名
まつうらかなん	松浦果南	人名
まつうら	松浦	姓
かなん	果南	名
くろさわだいや	黒澤ダイヤ	人名
くろさわ	黒澤	姓
だいや	ダイヤ	名
わたなべよう	渡辺曜	人名
わたなべ	渡辺	姓
よう	曜	名
つしまよしこ	津島善子	人名
つしま	津島	姓
よしこ	善子	名
くにきだはなまる	国木田花丸	人名
くにきだ	国木田	姓
はなまる	花丸	名
おはらまり	小原鞠莉	人名
おはら	小原	姓
まり	鞠莉	名
くろさわるびぃ	黒澤ルビィ	人名
るびぃ	ルビィ	名
いなみあんじゅ	伊波杏樹	人名
あいだりかこ	逢田梨香子	人名
すわななか	諏訪ななか	人名
こみやありさ	小宮有紗	人名
さいとうしゅか	斉藤朱夏	人名
こばやしあいか	小林愛香	人名
たかつきかなこ	高槻かなこ	人名
すずきあいな	鈴木愛奈	人名
ふりはたあい	降幡愛	人名
うらのほし	浦の星	名詞
せいんとすのー	Saint Snow	名詞
